1111111111111111
1121212121212121
1212121212121211
1121212121212121
1212121212121211
1121212121212121
1212121212121211
1121212121212121
1212121212121211
1121212121212121
1212121212121211
1111111111111111